M________X_____
_XXXXXXX_X_XXXX
____X___XXX__X_
XXX_XX_XXX___X_
__________XX___
XXX_X___XX_XXXX
____X_X__X_X___
_XXXX_XX_X_XXXX
______X__X_____
XXXXXXX_XXXX_XX
__X___X________
_XX_X_X_XX_XXX_
____X_X_X____X_
_XXXXXX_XXXXXX_
_____________XG