M________X______
_XXXXXXX_X_XXXX_
____X____XXX__X_
____XX________X__
________________
_XXXX___XX_XXXX
________________
________________
________________
XXXXXXX_XXXX_XXX
__X___X_________
_XX_X_X_XX_XXXX_
____X_X_X_____X_
_XXXXXX_XXXXXXX_
_______________G